         #        *       !
         #        *
         *        *
      #     #     *
#####*########   #
#     *   *  #   #
#         *      #
#     #          #
#  ##########*####
#        
#      ####*##
#     #       #
###############*#########